AND	NYSE
CHE	NYSE
COCO	NASDAQ
EVR	NYSE
GLDD	NASDAQ
LPLA	NASDAQ
MATW	NASDAQ
SCOR	NASDAQ
GLTR	NYSE
ALUM	NYSE
ENER	NASDAQ
PTF	NYSE
STAA	NASDAQ
ZINC	NASDAQ
XLYS	NASDAQ
XLBS	NASDAQ
XLES	NASDAQ
XLFS	NASDAQ
XLIS	NASDAQ
XLKS	NASDAQ
XLPS	NASDAQ
XLUS	NASDAQ
XLVS	NASDAQ
NGAS	NASDAQ
LIME	NASDAQ
NICK	NASDAQ
APA	NYSE
NKY	NYSE
